111111111111111
1000000010000E1
1000C0001001001
100000001001111
111111100001C01
100000000001001
111100011111011
100000000000001
101000000000001
1C1111110000001
101111110000001
1P111111C000001
111111111111111